{
    "rows" : 20,
    "columns" : 20,
    "data" : ["0,0,0,0,0,0,0,0,0,0,0,0,0,0,0,0,0,0,0,0",
              "0,1,1,1,1,1,1,3,1,1,1,1,1,1,1,1,1,1,1,0",
              "0,0,0,1,0,0,0,0,0,0,1,0,0,0,0,0,3,0,0,0",
              "0,0,0,1,0,0,0,0,0,0,1,0,0,0,0,0,1,0,0,0",
              "0,1,1,3,1,1,1,1,1,1,1,1,1,1,1,1,1,1,1,0",
              "0,0,0,0,1,0,0,0,0,1,0,0,0,0,0,1,0,0,0,0",
              "0,0,0,0,1,0,0,0,0,1,0,0,0,0,0,1,0,0,0,0",
              "0,1,1,1,1,1,1,1,1,1,1,1,1,1,1,1,1,1,1,0",
              "0,0,0,0,0,0,1,1,0,0,1,0,0,1,1,0,0,0,0,0",
              "0,1,1,1,1,1,1,1,0,4,1,4,0,1,1,1,1,3,1,0",
              "0,1,1,1,1,3,1,1,0,4,1,4,0,1,1,1,1,1,1,0",
              "0,0,0,0,0,0,1,1,0,1,0,0,0,1,1,0,0,0,0,0",
              "0,1,1,3,1,1,1,1,1,1,1,1,1,1,1,1,1,1,1,0",
              "0,0,1,0,0,0,0,0,0,0,1,0,0,0,0,0,0,1,0,0",
              "0,0,1,0,0,0,0,0,0,0,1,0,0,0,0,0,0,1,0,0",
              "0,1,1,1,1,1,1,1,1,1,5,1,1,1,1,1,1,1,1,0",
              "0,0,0,1,0,0,0,0,0,1,0,0,0,0,0,0,1,0,0,0",
              "0,0,0,1,0,0,0,0,0,1,0,0,0,0,0,0,1,0,0,0",
              "0,1,1,1,1,3,1,1,1,1,1,1,1,1,1,1,1,3,1,0",
              "0,0,0,0,0,0,0,0,0,0,0,0,0,0,0,0,0,0,0,0",
             ]
}